%%%%%%%%%%%%%%%%%%%%%%%%%%%%%%%%%%%%%%%%%%%%%%%%%%%%%%%%%%%%%%%%%%%%%%%%%%%%%%%%%%%%%%%%%%%%%%%%%%%%
%  %         %         %                  %  %        % %  %   %%              % %         %    % P%
%      % %                             %                   %                                   %   %
%   %  %    %      %      % %                 %                              %                     %
%    %     %             %              %    %    %             %  %%          %                   %
%% %       % %                           %% %   %     %            %              % %              %
% %%  %    %%   % % %   %%     %       %             %    % %   % %   %                  %    %  %%%
%         %   %                    % %                     % %          %     %                 %% %
%       %               %                      %             %         %              %            %
%  %     %          %                  %   % %     %  %  %    %    %    %       %%                 %
%      %    %       %          %               %     % %  %             %              %%          %
%         %  %%   %        % %%    %      %         % %                                    %       %
%%%   %         %           %                 %                    %         %                    %%
%               %   %             %            %   %%       %        %   %   % %            %      %
%                  %    %   %     % %%               %    %         %   %      %   %   %  %    %   %
%  %                        %   %%   %                                     %             %   %     %
%%     %         %   %          %   %               %  %                 %   %                    %%
%  %    %   %               %               %              %            %                %   %     %
%        %                      %  %     %        %                    %  %        %%    %   %     %
%%                   %    %            % %          %          %                      %   %%       %
%                      %                                   %                     %            %    %
%           %                         %%   %          %   %                                        %
%             %                   %    %                    %%                          %          %
%     %                                      %                 %   %        %                      %
%     %                                                                      %      %       %  %   %
%                                          %                      %           %  %%                %
%   %          %     % %     % %                              %                  %                 %
%  %        % %                        %% %                                        %    %   %      %
%        %     %          %  %           %  %%   %     %  %        %                     %         %
%     %                                        %     %                      % %     %%    %        %
% %                  %       %   %   %                                        %           % %      %
%        % %             %  %              %       %        %    %          % %     %              %
%   %       %  %               %   %         %             %                       %              %%
% %   %       %   %           %                         %                                          %
%               %%                            %     %              %             %%% %             %
%    %                 %          %                     %  %      %        %                       %
%     %                        %          % %         %   %%          %         %      %         % %
%   %            %  %         %  %                     % %     %            %       %          %   %
%   %%    %  %                     %     %                       %     %   %                %      %
%   %             %        %                     %                %  %                    % %      %
%            %  %  %       %    %   %                %                   %                         %
% %                                  % %%  %          %%        %          %          %          % %
%   %         % %           % %    %               %    %   %       %%                           % %
%    %   %   %    %    %  %       %     %%            %   %%%           %      %  %                %
%          %                           %           % %           %                                 %
%    %              %      %%    %                  %                    %       %         %       %
%                                                 %   %             %          %   %               %
%           %              %  %          %                                                       % %
%            %         %       %                % %          %    %              %     % %       % %
%            %       %  %                   %       %%   %               %       %                 %
%          %                  %   %      %     %    %       %       %           %    %           % %
%  %    % %   %                       %                    %% %%              %                    %
%%            %                          %   %        %   %                               %        %
%   % %         %%      %   %                           % %         %%           %   %      %      %
%     %       %   %       %          % %       %   %%        %        %                    %    %  %
% %      %     %         %  %      %%  %     %     %            %                        %    %    %
% %                               %                         % %         %     %               %  % %
%            %          %                         %             %                                  %
%   %                         %            %                                                    %  %
%       %                            %%  %             %       %           %               %  %    %
%         %    %    %  % %                                              %%                %        %
%          %          %     %         % %%             %     %           %      %   %        %%    %
%  %    %      %%         %                     %           %                                   %  %
%           %%          %                         %                  % %                %          %
% %             %           %               %% %            %  %   %   % %               %       % %
%        %      %   %                 %%             %%%        %     %                     %      %
%                     %           %           %            %    %     %  %  %            %      % %%
%  %     %   %   %   %                            %%                %%    %            %           %
% %            %        %                %     %               % %         % %  %            %     %
%     %                 %     %      %%                   %      %  %          % %               %%%
%    %          %%       %       %%%    %     %   %               %                      % %     % %
%      % %           %                      %   %%                    %                   %%       %
%        %          %    %                   %    %    %%         %%                 %%         %  %
%  %                              %    %   %    %     %% %   %             % %               %     %
%                 %    % %  %      %   %        %                                                  %
%% %   %   %    %   %%     %        %                      %    %   %  %%     %                    %
%         %              %               %                  %                                   % %%
% %             %      %                        %                 %   %           %         %  %   %
%       %  %                                         %      %    %       %                         %
%    % %         %%                 %                             %%                      % %      %
%                                 %   %  %       %                             %%  % %             %
%             %   %       %      % %    %          %    %                                      %   %
%    %   %        %  %       %%      %%   %    %                        %              %      %    %
%  %%  %  %          %             % %              % %  %        %  %                            %%
%  %                %  %                                      %     %             % %  %   %  %    %
%                               %  %   %%%                  %    %        %                  %     %
%      %                              % %      % %                                 %               %
%     %               %                             % % %%            %                  %     %   %
% %  %                 %                            %                        %                     %
%                                         %           %                           %                %
%      %    %%                  %           %       %                   %      %          %        %
% %  %     %          %  %%       %  %            %       %                                %      %%
%         %                         %            %   %           % %%             %              % %
%       %        %      %        %      %   %            %                  %                      %
%     %%          %  %        %              %            %       %             %    %       %     %
%%    %   %%          %       %       %    %       %     %   %                    %       %%   %   %
%      % %      %   %      %   %  %           %         %    %        %                     %      %
%         %  %%        %      %                %   %                     %  %   %%                 %
%.    %          %                           %                           %                     %   %
%%%%%%%%%%%%%%%%%%%%%%%%%%%%%%%%%%%%%%%%%%%%%%%%%%%%%%%%%%%%%%%%%%%%%%%%%%%%%%%%%%%%%%%%%%%%%%%%%%%%
